########
#      #
# $$@  #
# . .# #
#   #  #
########
