#######
#     #
#.$@$.#
#  .  #
#######
