##########
#   .    #
#   $    #
#   $    #
#   $    #
#   @    #
#   .    #
##########
