##########
# .   .  #
# $$#$$#@#
#   #    #
##########
