###########     #####################
#   .  .  #     #                  .#
#  # #    #     #              #    #
#  #$# $  #######               #   #
#                        .    # $   #
#  #$#@   #######                   #
#  # #    #     #                   #
#   .  *  #     #                   #
###########     #####################