########
#  .   #
# $$#@ #
# . #  #
#      #
########
