############
#@     .   #
# $$$$$$   #
#     .    #
############
