##########
#   .    #
#  # #   #
#  #$#   #
#  #$#@  #
#  # #   #
#   .    #
##########
