###########
#   .  .  #
#  # #    #
#  #$# $  #
#         #
#  #$#@   #
#  # #    #
#   .  *  #
###########
