########
#      #
# $$#@ #
# . .# #
#   #  #
########
