########
#      #
# @$ $ #
#  . . #
#      #
########
